{
	"MapKey": "ExampleMap",
	"DisplayName": "Example Map",
	"Width": 11,
	"Hight": 11,
	"Terrain": [
		1,1,1,1,1,1,1,1,1,1,1,
		1,0,0,0,0,0,0,0,0,0,1,
		1,0,0,0,0,0,0,0,0,0,1,
		1,0,0,0,1,0,0,1,0,0,1,
		1,0,0,1,0,0,0,0,0,0,1,
		1,0,0,0,0,0,0,0,0,0,1,
		1,0,0,0,0,0,0,0,0,0,1,
		1,0,0,1,0,0,0,1,0,0,1,
		1,0,0,0,0,0,0,0,0,0,1,
		1,0,0,0,0,0,0,0,0,0,1,
		1,1,1,1,1,1,1,1,1,1,1
	]
}
