{
	"MapKey": "FirstMap",
	"DisplayName": "First Map",
	"Width": 16,
	"Hight": 21,
	"Terrain": [
		1,1,1,1,1,1,1,1,1,1,1,1,1,1,1,1,
        1,1,1,0,0,0,0,1,1,0,0,0,0,1,1,1,
        1,1,1,0,0,0,0,0,0,0,0,0,0,0,1,1,
        1,1,0,0,0,0,0,0,0,0,0,0,0,0,0,1,
        1,0,0,0,0,0,0,0,0,0,0,0,0,0,0,1,
        1,1,0,0,0,0,0,0,0,0,0,0,0,0,1,1,
        1,0,0,0,0,0,0,0,0,0,1,1,1,1,1,1,
        1,1,1,0,0,0,0,0,0,1,1,0,0,1,1,1,
        1,1,1,1,0,0,0,1,1,1,1,0,0,0,1,1,
        1,1,1,0,0,0,0,1,1,1,1,0,0,0,0,1,
        1,1,1,0,0,0,0,0,0,0,0,0,0,0,0,1,
        1,0,0,0,0,0,0,1,1,1,1,0,0,1,1,1,
        1,1,1,1,0,0,0,0,0,1,1,1,1,1,1,1,
        1,1,1,1,0,0,0,0,0,0,1,1,1,1,1,1,
        1,1,1,1,0,0,0,0,1,1,1,1,1,1,1,1,
        1,1,0,0,0,0,0,1,1,1,1,1,1,1,1,1,
        1,0,0,0,0,0,0,1,1,1,1,0,0,1,1,1,
        1,0,0,0,0,0,0,0,1,1,0,0,0,0,1,1,
        1,1,0,0,1,1,0,0,0,0,0,0,0,0,1,1,
        1,1,1,1,1,1,1,1,1,1,0,0,0,1,1,1,
        1,1,1,1,1,1,1,1,1,1,1,1,1,1,1,1
	]
}
